    ############################
    #A         #               #
    #  ####### # ######## ###  #
    #  #     # # #      #   #  #
    #  # ### # # # #### # # #  #
    #  # #   # #   #    # # #  #
    #  # # ### ##### #### # #  #
    #  # # #         #    # #  #
    #  #   # ####### # #### #  #
    #  #   # #     # #    # #  #
    #  ##### # ### # #### # #  #
    #        #   # #    #   #  #
    # ############ # # #### #  #
    #              #   #    #  #
    ################## #### #  #
    #                  #    #  #
    # ################ # ## #  #
    # #              # #  # #  #
    # # ############ # ## # #  #
    # # #          # #  # # #  #
    # # # ######## # ## # # #  #
    # # # #      # #  # # # #  # 
    # # # # #### # ## # # # #  #
    # # # # #  # #  # # # # #  #
    # #   # #  # #    # # # #  #
    # ##### #  # ###### # # #  #
    #          #        # # #  #
    # ########## ######## # #  #
    #                     #   B#
    ############################
    